H 0 ##          ------------
H#####       ##H            
H#####       ##H #@#@#@#@#@#
H#####       ##H $ $ $ $ $ $
H##$##       ##H#X#X#X#X#X#X
H##### $  0  ##H#X#X#X#X#X#X
H##############H------------
H##############H   @ @ @ @ @
H  & 0         H   #X#X#X###
H########H########H     X###
H########H   #####H####HX###
H########H##$  ###H####HX###
H########H####$  #H 0  HX###
         H######  H####HX###
    $ $  H########H####HX###
##################H $$ HX###
