HH #####0H@@@ @@@H0##### HH@
H@HH $ HH@HHHHHHH@HH $ HH@HH
$H@H#H#H@H$##H##$H@H#H#H@H$#
# H@HHH@H # HHH # H@HHH@H #H
 #HH@H@HH# H   H #HH@H@HH#  
H# HHHHH #H ### H# HHHHH #H#
H#H     H#H# $ #H#H     H#H&
H# HHHHH #H ### H# HHHHH #H#
 #HH@H@HH# H   H #HH@H@HH#  
X H@HHH@H # HHH # H@HHH@H #H
$H@H#H#H@H$##H##$H@H#H#H@H$#
H@HH $ HH@HHHHHHH@HH $ HH@HH
@H ##### H@@@H@@@H ##### H@@
@H H $ H H@@HHH@@H H $ H H@@
@H H#H#H0HH@HHH@HH0H#H#H H@@
H@H@HHH@H@HHHHHHH@H@HHH@H@HH
