     S                      
     S           @@@@@@@@@@@
@@@@@S@@@@@H----H          @
@    S     H &  H   0      @
#####H######################
##H  H  H###    ####      ##
#HH#####H### ## ############
#H###### H## $# ### ##  ## #
#H# ### #H## ## ### $### $ #
#H## $ ##H##    ### ## $## #
#H#######H#########X########
#H  # #$ HH              0H#
#H####### H########H######H#
#H $###   H      ##H      H#
#H      0 H   $  ##H   $  H#
############################
