       --          --    -- 
 ######$-H########H-$####$- 
 #######$H########H$######$ 
 ########H########H######## 
 ### ####H###     H###   ## 
 ###  ###H###$$$  H###$$$-- 
 ###  ###H######  H######$- 
 ###  ###H######  H ######$ 
 ###  ###H######  H  ###### 
 ### $###H###     H     ### 
 ###$####H###$$$$$H##$$$### 
 ########H########H##X##### 
 ####### H########H #X####  
 ######  H########H  X###   
  0  0   H   &    H   0  0  
#########S###HH###S#########
