S                           
S    #   0 #       0   0    
S------$H#H ##H##SS#SS##H   
H      #H #H# H# $# $#  H   
H &     #  # H# H#  #   H   
#####    ## H#  #  #    H   
    #   $# H# $#  # --- H   
   #    # HHH #    #  #####H
 $#   $#  #HH#  ##  X      H
##    # $# H#  #  #  #     H
#   $#  # H#  #    #  #$   H
    # $# H# $#  H#  #$ #   H
  $#  # H#  #   H #  #  #  H
  # $# H#  #    H  #$ #  # H
 #  # HH     $  H   #     #H
      H##################  H
