                     000    
                  $$$$$$S   
           $$$$$$S#######   
    $$$$$$S@@@@@@@          
   S#######                 
   SS                       
    S                       
$$$$S                       
####H                       
##########H                 
###############H            
###################H        
######################H     
########################H   
#########################H  
#########################H& 
