             SS             
  0 HHHHH  $$SS$$  HHHHH 0  
    HHHHH H######H HHH H    
  H#H H H H  $   H H H H#H  
  H#H H H H######H H H H#H  
   #H H H-H  & $ H-H H H#   
   $@ H @-########-@ H @$   
   XH H H-H######H-H H HX   
  HXH H H-H######H-H H HXH  
  HHH H H  H#XX#H  H H HHH  
  HHH H H  H#XX#H  H H HHH  
   HH H H   #$$#   H H HH   
    HHH H          H HHH    
     HHHH          HHHH     
      HHH          HHH      
       0H##########H0       
