#######HH----------HH#######
######HH   -    -   HH######
#####HH     #00#     HH#####
####HH    - #### -    HH####
###HH    - ###### -    HH###
##HH----- ######## -----HH##
#HH    - ####$$#### -    HH#
HH      ############      HH
#HH    - ####$$#### -    HH#
##HH    - ######## -    HH##
###HH    - ###### -    HH###
####HH    - #### -    HH####
#####HH    -    -    HH#####
######HH            HH######
#######HH0   &    0HH#######
############################
