@S                         @
@S@@@@ @@@@@@@@@#@@@@@@@@@$@
@S    $   $----   --------H@
@S       H##  #####     ##H@
@S     $ H       $#  # $#$H@
@S    ###H  $ &  ##  #X##@H@
@S $     H#####H  # 0     H@
@S ###   H#   #H  #---H####@
@S     0 H#$  #H  #   H--- @
@S   H#########H###   H  $ @
@### H#$ # $  #   #   H ###@
@$ ##H#########   #   H #  @
@####H---$$@$$#$  ##@@@H@##@
@   #H  ###@#####H#    H  $@
@ $ #H    $      HH  0 H#H @
#####H############H#########
