----------        ----------
H         ########         H
H       ############       H
H   0  ##############  0   H
H @@@@################@@@@ H
H        ##########        H
H @H        ####        H@ H
@@@H                    H@@@
   H  $  $  $  $  $  $  H   
   H                    H   
   H        ####        H   
   H     ###XXXX###  &  H   
   H  ###XXXXXXXXXX###  H   
   H   XXXXXXXXXXXXXX   H   
   H    XXXXXXXXXXXX    H   
   H      XXXXXXXX      H   
