S                          S
S      &            0      S
S   @#H#@----------@#H#@   S
S   @$H @ $      $ @ H @   S
S @## H ##@      @## H$##@ S
SS@$  H  $@ $   $@ $ H #$@SS
@S### H   ##@  @#####H # #S@
@     H     @ $@$    H #  $@
@     H#####@H#@##  $H ## #@
@ $ 0 H   0  H     ##H     @
@H####H   @##H###@   H   #H@
 H@ $ H   #  H $ #   H  0@H 
 H@## H ###  H   ### H ##@H 
 H $@ H @    H    $@ H @$ H 
 H   ###     H      ###   H 
############################
