@S                        S@
@S  0$$$$$$$$ $$$$$$$$$0  S@
@@@@@@@@@@@@@S@@@@@@@@@@@@@@
      $ $    S     $  $     
    @H@@@@   S   @H@@@@@    
     H$ $    S    H$  $     
   @@@@@@H@  S  @@@@@@@H@   
      $ $H   S     $  $H    
  @H@@@@@@@@ S @H@@@@@@@@@  
   H  $ $    S  H  $  $     
 @@@@@@@@@@H@S@@@@@@@@@@@H@ 
      $  $ H S    $   $  H  
 @H@@@@@@@@@@S@@@@@@@@@@@@@ 
  H                         
  H   $  $      & $   $    0
############################
