                     S      
    0           @    S   0 $
H@@@@@ @@@@@@@H@@   #S#H####
H       ---   H@$##H#S#H####
##H## ##  H#0 H ###H#S#H##$#
  H  ##$# H # H##  H#S#H####
H#   ####XH  #H  H###S#H    
H    &    H   #  H#  S ####H
H######## # $#  $H#H#######H
H########X# #  ####H##     H
H########X#     $##H  ######
H##$   ##X#----H# #H------  
H##   $##X#H   #  #$    # #H
H########X#H  #######H###$#H
H   ##$    H ##      H  ###H
H##########H###########    H
