S                          S
S--------------------------S
HH                        HH
H  #X##    ###X##  ######  H
H  #  ##   #    #  #    X  H
H  #   ##  #       #       H
H  #    #  #       #       H
H  #   $#  #    $  #       H
H  #   ##  #   ##  #    $  H
H  #$ ##   #   $#  #$  $#  H
H  ####    ###X##  ##X###  H
H      &                   H
H H######  ######  #H####  H
H H#   $#  ######H #H##$#  H
H0H#    # 0## $##H  H####  H
############################
