                  H   S     
        --        H   S     
$   $  -- H     --H  $S0    
####H--   H 0  ---#X##H#H   
    H  @#X#H  ---$#$  S#H   
XX###H  $  H-H@@ @######H   
X$   H  @    H   @@@@ --H   
 X$  H      $H $     H@     
  #$ H#X##H@@@@@@H#X@H@     
  H#$H    H  $   H   H@     
  H XH@   H#X####H##@H@     
  H -H  $ H  $   H  @H@     
  H@ $  @ H####X#H @$H$@    
  H  @    H  $   H @@H@@    
  H       H##X###H  0H      
##########H  0  &H##########
