S                          S
S                          S
######H####H0 0H####H#######
 -    H    H@H@H    H     - 
H #####      H   $  ###### H
H #####  #HHHHHHH#  ###### H
H ###$#  #H@@@@@H#  ##$### H
H #####  #HHHHHHH#  ###### H
H         -------          H
H 0   H      @      H    0 H
H@@@@@H    $@@@$    H@@@@@@H
H     H    @@@@@    H      H
H#####H   @@@@@@@   H######H
H     H $@@@@@@@@@$ H      H
H@@@@@H @@@@@@@@@@@ H@@@@@@H
$     H@@@@@@@@@@@@@H  &   $
