 --------#          0       
H        #  $    H####H # #H
H XXXXXX #####H@ H@   H # #H
H XXXXXX #  $ H@ H@H@ H # #H
H XXXXXX #H####@ H@H@ H # #H
H XX$$XX #H $  @ H@H@ H # #H
H XXXXXX #####H@ H@H@ H # #H
H XXXXXX #  $ H@ H@H@ H #$#H
H       0#H####@ H@H@ H ##XH
H#########H $  @ H@H@ H    H
H#############H@##@H@######H
H#########  $ H@@@@H@@@@###H
H##$$#####H####@ $ S $ @$##H
H########$H@#@@@@@@@@@@@###H
H@@@@@@@@@@       $  0$    H
H &        H################
