         S                  
         S       $      0   
###      S      ####H#######
  ##     S     ##   H       
   ##    S    ##    H       
$0 ###   S  $###    H   $   
##H####  S  ####H###H#######
  H   ## S ##   H           
  H$0  ##H##    H     $     
H###H    H     #H##H###     
H   H              H        
H   H    $     0   H        
H   H#######H######H#####H##
H           H            H  
H           H  &         H  
############################
